33x33
  ;  ;  ;  ;  ;  ;  ;  ;  ;  ;  ;  ;  ;  ;  ;  ;  ;  ;  ;  ;  ;  ;  ;  ;  ;  ;  ;  ;  ;  ;  ;  ;  ;
  ;  ;  ;  ;  ;  ;  ;  ;  ;  ;  ;  ;  ;  ;  ;  ;  ;  ;  ;  ;  ;  ;  ;  ;  ;  ;  ;  ;  ;  ;  ;  ;  ;
  ;  ;  ;  ;  ;  ;  ;  ;  ;  ;  ;  ;  ;  ;  ;  ;  ;  ;  ;  ;  ;  ;  ;  ;  ;  ;  ;  ;  ;  ;  ;  ;  ;
  ;  ;  ;  ;  ;  ;  ;  ;  ;  ;  ;  ;  ;  ;  ;  ;  ;  ;  ;  ;  ;  ;  ;  ;  ;  ;  ;  ;  ;  ;  ;  ;  ;
  ;  ;  ;  ;  ;  ;  ;  ;  ;  ;  ;  ;  ;  ;  ;  ;  ;  ;  ;  ;  ;  ;  ;  ;  ;  ;  ;  ;  ;  ;  ;  ;  ;
  ;  ;  ;  ;  ; X; X; X; X; X; X; X; X; X; X; X; X; X; X; X; X;  ;  ;  ;  ;  ;  ;  ;  ;  ;  ;  ;  ;
  ;  ;  ; X; X; X; X; X; X; X; X; X; X; X; X; X; X; X; X; X; X; X;  ;  ;  ;  ;  ;  ;  ;  ;  ;  ;  ;
  ;  ;  ; X; X; X; X; X; X; X; X; X; X; X; X; X; X; X; X; X; X; X;  ;  ;  ;  ;  ;  ;  ;  ;  ;  ;  ;
  ;  ;  ; X; X; X; X; X; X; X;TO; X; X; X;TO; X; X; X; X; X; X; X;  ;  ;  ;  ;  ;  ;  ;  ;  ;  ;  ;
  ;  ;  ; X; X; X; X;TO;WK;WK;WK;WK;WK;WK;WK;WK;WK;TO; X; X; X; X;  ;  ;  ;  ;  ;  ;  ;  ;  ;  ;  ;
  ;  ;  ; X; X; X; X;WK;WK;WK;WK;WK;WK;WK;WK;WK;WK;WK; X; X; X; X;  ;  ;  ;  ;  ;  ;  ;  ;  ;  ;  ;
  ;  ;  ; X; X; X; X;WK;WK;WK;WK;WK;WK;WK;WK;WK;WK;WK; X; X; X; X;  ;  ;  ;  ;  ;  ;  ;  ;  ;  ;  ;
  ;  ;  ; X; X; X; X;WK;WK; X; X;TO;WK;WK; X; X;WK;WK; X; X; X; X;  ;  ;  ;  ;  ;  ;  ;  ;  ;  ;  ;
  ;  ;  ; X; X; X; X;WK;WK; X; X;WK;WK;WK; X; X;WK;WK; X; X; X; X;  ;  ;  ;  ;  ;  ;  ;  ;  ;  ;  ;
  ;  ;  ; X; X; X; X;WK;WK;WK;WK;WK;WK;WK;WK;WK;WK;WK; X; X; X; X;  ;  ;  ;  ;  ;  ;  ;  ;  ;  ;  ;
  ;  ;  ; X; X; X; X;WK;WK;WK;WK;WK;WK;WK; X; X;WK;WK; X; X; X; X;  ;  ;  ;  ;  ;  ;  ;  ;  ;  ;  ;
  ;  ;  ; X; X; X; X;WK;WK;WK;WK;WK;WK;WK; X;TW;WK;WK; X; X; X; X;  ;  ;  ;  ;  ;  ;  ;  ;  ;  ;  ;
  ;  ;  ; X; X; X; X;TO;WK;WK;WK;WK;WK;WK; X; X;WK;WK; X; X; X; X;  ;  ;  ;  ;  ;  ;  ;  ;  ;  ;  ;
  ;  ;  ; X; X; X; X; X; X; X; X; X; X; X; X; X; X; X; X; X; X; X;  ;  ;  ;  ;  ;  ;  ;  ;  ;  ;  ;
  ;  ;  ; X; X; X; X; X; X; X; X; X; X; X; X; X; X; X; X; X; X; X;  ;  ;  ;  ;  ;  ;  ;  ;  ;  ;  ;
  ;  ;  ;  ; X; X; X; X; X; X; X; X; X; X; X; X; X; X; X; X; X; X;  ;  ;  ;  ;  ;  ;  ;  ;  ;  ;  ;
  ;  ;  ;  ; X; X; X; X; X; X; X; X; X; X; X;  ;  ;  ;  ;  ;  ;  ;  ;  ;  ;  ;  ;  ;  ;  ;  ;  ;  ;
  ;  ;  ;  ;  ;  ;  ;  ;  ;  ;  ;  ;  ;  ;  ;  ;  ;  ;  ;  ;  ;  ;  ;  ;  ;  ;  ;  ;  ;  ;  ;  ;  ;
  ;  ;  ;  ;  ;  ;  ;  ;  ;  ;  ;  ;  ;  ;  ;  ;  ;  ;  ;  ;  ;  ;  ;  ;  ;  ;  ;  ;  ;  ;  ;  ;  ;
  ;  ;  ;  ;  ;  ;  ;  ;  ;  ;  ;  ;  ;  ;  ;  ;  ;  ;  ;  ;  ;  ;  ;  ;  ;  ;  ;  ;  ;  ;  ;  ;  ;
  ;  ;  ;  ;  ;  ;  ;  ;  ;  ;  ;  ;  ;  ;  ;  ;  ;  ;  ;  ;  ;  ;  ;  ;  ;  ;  ;  ;  ;  ;  ;  ;  ;
  ;  ;  ;  ;  ;  ;  ;  ;  ;  ;  ;  ;  ;  ;  ;  ;  ;  ;  ;  ;  ;  ;  ;  ;  ;  ;  ;  ;  ;  ;  ;  ;  ;
  ;  ;  ;  ;  ;  ;  ;  ;  ;  ;  ;  ;  ;  ;  ;  ;  ;  ;  ;  ;  ;  ;  ;  ;  ;  ;  ;  ;  ;  ;  ;  ;  ;
  ;  ;  ;  ;  ;  ;  ;  ;  ;  ;  ;  ;  ;  ;  ;  ;  ;  ;  ;  ;  ;  ;  ;  ;  ;  ;  ;  ;  ;  ;  ;  ;  ;
  ;  ;  ;  ;  ;  ;  ;  ;  ;  ;  ;  ;  ;  ;  ;  ;  ;  ;  ;  ;  ;  ;  ;  ;  ;  ;  ;  ;  ;  ;  ;  ;  ;
  ;  ;  ;  ;  ;  ;  ;  ;  ;  ;  ;  ;  ;  ;  ;  ;  ;  ;  ;  ;  ;  ;  ;  ;  ;  ;  ;  ;  ;  ;  ;  ;  ;
  ;  ;  ;  ;  ;  ;  ;  ;  ;  ;  ;  ;  ;  ;  ;  ;  ;  ;  ;  ;  ;  ;  ;  ;  ;  ;  ;  ;  ;  ;  ;  ;  ;
  ;  ;  ;  ;  ;  ;  ;  ;  ;  ;  ;  ;  ;  ;  ;  ;  ;  ;  ;  ;  ;  ;  ;  ;  ;  ;  ;  ;  ;  ;  ;  ;  ;
