41x41
  ;  ;  ;  ;  ;  ;  ;  ;  ;  ;  ;  ;  ;  ;  ;  ;  ;  ;  ;  ;  ;  ;  ;  ;  ;  ;  ;  ;  ;  ;  ;  ;  ;  ;  ;  ;  ;  ;  ;  ;  ;
  ;  ;  ;  ;  ;  ;  ;  ;  ;  ;  ;  ;  ;  ;  ;  ;  ;  ;  ;  ;  ;  ;  ;  ;  ;  ;  ;  ;  ;  ;  ;  ;  ;  ;  ;  ;  ;  ;  ;  ;  ;
  ;  ;  ;  ;  ;  ;  ;  ;  ;  ;  ;  ;  ;  ;  ;  ;  ;  ;  ;  ;  ;  ;  ;  ;  ;  ;  ;  ;  ;  ;  ;  ;  ;  ;  ;  ;  ;  ;  ;  ;  ;
  ;  ;  ;  ;  ;  ;  ;  ;  ;  ;  ;  ;  ;  ;  ;  ;  ;  ;  ;  ;  ;  ;  ;  ;  ;  ;  ;  ;  ;  ;  ;  ;  ;  ;  ;  ;  ;  ;  ;  ;  ;
  ;  ;  ;  ;  ;  ;  ;  ;  ;  ;  ;  ;  ;  ;  ;  ;  ;  ;  ;  ;  ;  ;  ;  ;  ;  ;  ;  ;  ;  ;  ;  ;  ;  ;  ;  ;  ;  ;  ;  ;  ;
  ;  ;  ;  ;  ;  ;  ;  ;  ;  ;  ;  ;  ;  ;  ;  ;  ;  ;  ;  ;  ;  ;  ;  ;  ;  ;  ;  ;  ;  ;  ;  ;  ;  ;  ;  ;  ;  ;  ;  ;  ;
  ;  ;  ;  ;  ;  ;  ;  ;  ;  ;  ;  ;  ;  ;  ;  ;  ;  ;  ;  ;  ;  ;  ;  ;  ;  ;  ;  ;  ;  ;  ;  ;  ;  ;  ;  ;  ;  ;  ;  ;  ;
  ;  ;  ;  ;  ;  ;  ;  ;  ;  ;  ;  ;  ;  ;  ;  ;  ;  ;  ;  ;  ;  ;  ;  ;  ;  ;  ;  ;  ;  ;  ;  ;  ;  ;  ;  ;  ;  ;  ;  ;  ;
  ;  ;  ;  ;  ;  ;  ;  ;  ;  ;  ;  ;  ;  ;  ;  ;  ;  ;  ;  ;  ;  ;  ;  ;  ;  ;  ;  ;  ;  ;  ;  ;  ;  ;  ;  ;  ;  ;  ;  ;  ;
  ;  ;  ;  ;  ;  ;  ;  ;  ;  ; X; X; X; X; X; X; X; X; X; X; X; X; X; X; X; X; X; X; X; X; X; X; X; X; X; X; X; X;  ;  ;  ;
  ;  ;  ;  ;  ;  ;  ;  ;  ;  ; X; X; X; X; X; X; X; X; X; X; X; X; X; X; X; X; X; X; X; X; X; X; X; X; X; X; X; X;  ;  ;  ;
  ;  ;  ;  ;  ;  ;  ;  ;  ;  ; X; X; X; X; X; X; X; X; X; X; X; X; X; X; X; X; X; X; X; X; X; X; X; X; X; X; X; X;  ;  ;  ;
  ;  ;  ;  ;  ;  ;  ;  ;  ;  ; X; X; X; X; X; X; X; X; X; X; X; X; X; X; X; X; X; X; X; X; X; X; X; X; X; X; X; X;  ;  ;  ;
  ;  ;  ;  ;  ;  ;  ;  ;  ;  ; X; X; X; X;WK;WK;TO;WK;WK;WK;WK;WK;WK;WK;WK;WK;WK;WK;WK;WK;WK;WK;WK;WK; X; X; X; X;  ;  ;  ;
  ;  ;  ;  ;  ;  ;  ;  ;  ;  ; X; X; X; X;WK;WK;WK;WK;WK;WK;WK; X; X; X; X;WK;TO;WK; X; X; X; X;WK;WK; X; X; X; X;  ;  ;  ;
  ;  ;  ;  ;  ;  ;  ;  ;  ;  ; X; X; X; X;WK;WK;WK;WK;WK;WK;TO; X; X; X; X;WK;WK;WK; X; X; X; X;WK;WK; X; X; X; X;  ;  ;  ;
  ;  ;  ;  ;  ;  ;  ;  ;  ;  ; X; X; X; X;WK;WK;WK;WK;WK;WK;WK;WK;WK;WK;WK;WK;WK;WK;WK;WK;WK;WK;WK;WK; X; X; X; X;  ;  ;  ;
  ;  ;  ;  ;  ;  ;  ;  ;  ;  ; X; X; X; X; X; X; X;WK;WK;WK; X; X; X; X; X; X; X; X; X; X; X; X; X; X; X; X; X; X;  ;  ;  ;
  ;  ;  ;  ;  ;  ;  ;  ;  ;  ; X; X; X; X; X; X; X;WK;WK;WK; X; X; X; X; X; X; X; X; X; X; X; X; X; X; X; X; X; X;  ;  ;  ;
  ;  ;  ;  ;  ;  ;  ;  ;  ;  ; X; X; X; X;WK;WK;WK;WK;WK;WK;WK;WK;WK;WK;TO;WK;WK;WK;WK;WK;WK;WK;WK;WK; X; X; X; X;  ;  ;  ;
  ;  ;  ;  ;  ;  ;  ;  ;  ;  ; X; X; X; X;TO;TO;WK;WK;WK;WK;WK;WK;WK;WK;WK;WK;WK;WK;WK;WK;WK;WK;TO;TO; X; X; X; X;  ;  ;  ;
  ;  ;  ;  ;  ;  ;  ;  ;  ;  ; X; X; X; X; X; X; X; X; X; X;TW; X; X; X; X; X; X; X; X; X; X; X; X; X; X; X; X;  ;  ;  ;  ;
  ;  ;  ;  ;  ;  ;  ;  ;  ;  ; X; X; X; X; X; X; X; X; X; X; X; X; X; X; X; X; X; X; X; X; X; X; X; X; X; X; X;  ;  ;  ;  ;
  ;  ;  ;  ;  ;  ;  ;  ;  ;  ; X; X; X; X; X; X; X; X; X; X; X; X; X; X; X; X; X; X; X; X; X; X; X; X; X; X; X;  ;  ;  ;  ;
  ;  ;  ;  ;  ;  ;  ;  ;  ;  ;  ;  ; X; X; X; X; X; X; X; X; X; X; X; X; X; X; X; X; X; X; X; X; X; X; X; X;  ;  ;  ;  ;  ;
  ;  ;  ;  ;  ;  ;  ;  ;  ;  ;  ;  ;  ;  ;  ;  ;  ;  ;  ;  ;  ;  ;  ;  ;  ;  ;  ;  ;  ;  ;  ;  ;  ;  ;  ;  ;  ;  ;  ;  ;  ;
  ;  ;  ;  ;  ;  ;  ;  ;  ;  ;  ;  ;  ;  ;  ;  ;  ;  ;  ;  ;  ;  ;  ;  ;  ;  ;  ;  ;  ;  ;  ;  ;  ;  ;  ;  ;  ;  ;  ;  ;  ;
  ;  ;  ;  ;  ;  ;  ;  ;  ;  ;  ;  ;  ;  ;  ;  ;  ;  ;  ;  ;  ;  ;  ;  ;  ;  ;  ;  ;  ;  ;  ;  ;  ;  ;  ;  ;  ;  ;  ;  ;  ;
  ;  ;  ;  ;  ;  ;  ;  ;  ;  ;  ;  ;  ;  ;  ;  ;  ;  ;  ;  ;  ;  ;  ;  ;  ;  ;  ;  ;  ;  ;  ;  ;  ;  ;  ;  ;  ;  ;  ;  ;  ;
  ;  ;  ;  ;  ;  ;  ;  ;  ;  ;  ;  ;  ;  ;  ;  ;  ;  ;  ;  ;  ;  ;  ;  ;  ;  ;  ;  ;  ;  ;  ;  ;  ;  ;  ;  ;  ;  ;  ;  ;  ;
  ;  ;  ;  ;  ;  ;  ;  ;  ;  ;  ;  ;  ;  ;  ;  ;  ;  ;  ;  ;  ;  ;  ;  ;  ;  ;  ;  ;  ;  ;  ;  ;  ;  ;  ;  ;  ;  ;  ;  ;  ;
  ;  ;  ;  ;  ;  ;  ;  ;  ;  ;  ;  ;  ;  ;  ;  ;  ;  ;  ;  ;  ;  ;  ;  ;  ;  ;  ;  ;  ;  ;  ;  ;  ;  ;  ;  ;  ;  ;  ;  ;  ;
  ;  ;  ;  ;  ;  ;  ;  ;  ;  ;  ;  ;  ;  ;  ;  ;  ;  ;  ;  ;  ;  ;  ;  ;  ;  ;  ;  ;  ;  ;  ;  ;  ;  ;  ;  ;  ;  ;  ;  ;  ;
  ;  ;  ;  ;  ;  ;  ;  ;  ;  ;  ;  ;  ;  ;  ;  ;  ;  ;  ;  ;  ;  ;  ;  ;  ;  ;  ;  ;  ;  ;  ;  ;  ;  ;  ;  ;  ;  ;  ;  ;  ;
  ;  ;  ;  ;  ;  ;  ;  ;  ;  ;  ;  ;  ;  ;  ;  ;  ;  ;  ;  ;  ;  ;  ;  ;  ;  ;  ;  ;  ;  ;  ;  ;  ;  ;  ;  ;  ;  ;  ;  ;  ;
  ;  ;  ;  ;  ;  ;  ;  ;  ;  ;  ;  ;  ;  ;  ;  ;  ;  ;  ;  ;  ;  ;  ;  ;  ;  ;  ;  ;  ;  ;  ;  ;  ;  ;  ;  ;  ;  ;  ;  ;  ;
  ;  ;  ;  ;  ;  ;  ;  ;  ;  ;  ;  ;  ;  ;  ;  ;  ;  ;  ;  ;  ;  ;  ;  ;  ;  ;  ;  ;  ;  ;  ;  ;  ;  ;  ;  ;  ;  ;  ;  ;  ;
  ;  ;  ;  ;  ;  ;  ;  ;  ;  ;  ;  ;  ;  ;  ;  ;  ;  ;  ;  ;  ;  ;  ;  ;  ;  ;  ;  ;  ;  ;  ;  ;  ;  ;  ;  ;  ;  ;  ;  ;  ;
  ;  ;  ;  ;  ;  ;  ;  ;  ;  ;  ;  ;  ;  ;  ;  ;  ;  ;  ;  ;  ;  ;  ;  ;  ;  ;  ;  ;  ;  ;  ;  ;  ;  ;  ;  ;  ;  ;  ;  ;  ;
  ;  ;  ;  ;  ;  ;  ;  ;  ;  ;  ;  ;  ;  ;  ;  ;  ;  ;  ;  ;  ;  ;  ;  ;  ;  ;  ;  ;  ;  ;  ;  ;  ;  ;  ;  ;  ;  ;  ;  ;  ;
  ;  ;  ;  ;  ;  ;  ;  ;  ;  ;  ;  ;  ;  ;  ;  ;  ;  ;  ;  ;  ;  ;  ;  ;  ;  ;  ;  ;  ;  ;  ;  ;  ;  ;  ;  ;  ;  ;  ;  ;  ;
