29x29
  ;  ;  ;  ;  ;  ;  ;  ;  ;  ;  ;  ;  ;  ;  ;  ;  ;  ;  ;  ;  ;  ;  ;  ;  ;  ;  ;  ;  ;
  ;  ;  ;  ;  ;  ;  ;  ;  ;  ;  ;  ;  ;  ;  ;  ;  ;  ;  ;  ;  ;  ;  ;  ;  ;  ;  ;  ;  ;
  ;  ;  ;  ;  ;  ;  ;  ;  ;  ;  ;  ;  ;  ;  ;  ;  ;  ;  ;  ;  ;  ;  ;  ;  ;  ;  ;  ;  ;
  ;  ;  ;  ;  ;  ;  ;  ;  ;  ; X; X; X; X; X; X; X; X; X;  ;  ;  ;  ;  ;  ;  ;  ;  ;  ;
  ;  ;  ;  ;  ;  ;  ; X; X; X; X; X; X; X; X; X; X; X; X;  ;  ;  ;  ;  ;  ;  ;  ;  ;  ;
  ;  ;  ;  ;  ;  ;  ; X; X; X; X; X; X; X; X; X; X; X; X; X; X; X; X; X; X;  ;  ;  ;  ;
  ;  ;  ;  ;  ;  ;  ; X; X; X; X; X; X; X; X; X; X; X; X; X; X; X; X; X; X;  ;  ;  ;  ;
  ;  ;  ;  ;  ;  ;  ; X; X; X; X; X; X; X;TW; X; X; X; X; X; X; X; X; X; X;  ;  ;  ;  ;
  ;  ;  ;  ;  ;  ;  ; X; X; X; X;WK;WK;WK;WK;WK;WK;WK;WK;WK;WK; X; X; X; X;  ;  ;  ;  ;
  ;  ;  ;  ;  ;  ;  ; X; X; X; X;WK;WK;WK;WK;WK;WK;WK;WK;WK;WK; X; X; X; X;  ;  ;  ;  ;
  ;  ;  ;  ;  ;  ;  ; X; X; X; X;TO;WK;WK;WK;WK;WK;WK;WK;WK;WK; X; X; X; X;  ;  ;  ;  ;
  ;  ;  ;  ;  ;  ;  ; X; X; X; X;WK;WK;WK;WK;WK;WK;TO; X; X;WK; X; X; X; X;  ;  ;  ;  ;
  ;  ;  ;  ;  ;  ;  ; X; X; X; X;WK;WK;WK;WK;WK;WK;WK; X; X;WK; X; X; X; X;  ;  ;  ;  ;
  ;  ;  ;  ;  ;  ;  ; X; X; X; X;TO;WK;WK;WK;WK;WK;WK;WK;WK;WK; X; X; X; X;  ;  ;  ;  ;
  ;  ;  ;  ;  ;  ;  ; X; X; X; X;WK;WK;WK;WK;WK;WK;WK;WK;WK;WK; X; X; X; X;  ;  ;  ;  ;
  ;  ;  ;  ;  ;  ;  ; X; X; X; X; X; X; X;TW; X; X; X; X; X; X; X; X; X; X;  ;  ;  ;  ;
  ;  ;  ;  ;  ;  ;  ; X; X; X; X; X; X; X; X; X; X; X; X; X; X; X; X; X;  ;  ;  ;  ;  ;
  ;  ;  ;  ;  ;  ;  ;  ;  ;  ; X; X; X; X; X; X; X; X; X; X; X; X; X; X;  ;  ;  ;  ;  ;
  ;  ;  ;  ;  ;  ;  ;  ;  ;  ; X; X; X; X; X; X; X; X; X; X; X; X; X; X;  ;  ;  ;  ;  ;
  ;  ;  ;  ;  ;  ;  ;  ;  ;  ;  ;  ;  ;  ;  ;  ;  ;  ;  ;  ;  ;  ;  ;  ;  ;  ;  ;  ;  ;
  ;  ;  ;  ;  ;  ;  ;  ;  ;  ;  ;  ;  ;  ;  ;  ;  ;  ;  ;  ;  ;  ;  ;  ;  ;  ;  ;  ;  ;
  ;  ;  ;  ;  ;  ;  ;  ;  ;  ;  ;  ;  ;  ;  ;  ;  ;  ;  ;  ;  ;  ;  ;  ;  ;  ;  ;  ;  ;
  ;  ;  ;  ;  ;  ;  ;  ;  ;  ;  ;  ;  ;  ;  ;  ;  ;  ;  ;  ;  ;  ;  ;  ;  ;  ;  ;  ;  ;
  ;  ;  ;  ;  ;  ;  ;  ;  ;  ;  ;  ;  ;  ;  ;  ;  ;  ;  ;  ;  ;  ;  ;  ;  ;  ;  ;  ;  ;
  ;  ;  ;  ;  ;  ;  ;  ;  ;  ;  ;  ;  ;  ;  ;  ;  ;  ;  ;  ;  ;  ;  ;  ;  ;  ;  ;  ;  ;
  ;  ;  ;  ;  ;  ;  ;  ;  ;  ;  ;  ;  ;  ;  ;  ;  ;  ;  ;  ;  ;  ;  ;  ;  ;  ;  ;  ;  ;
  ;  ;  ;  ;  ;  ;  ;  ;  ;  ;  ;  ;  ;  ;  ;  ;  ;  ;  ;  ;  ;  ;  ;  ;  ;  ;  ;  ;  ;
  ;  ;  ;  ;  ;  ;  ;  ;  ;  ;  ;  ;  ;  ;  ;  ;  ;  ;  ;  ;  ;  ;  ;  ;  ;  ;  ;  ;  ;
  ;  ;  ;  ;  ;  ;  ;  ;  ;  ;  ;  ;  ;  ;  ;  ;  ;  ;  ;  ;  ;  ;  ;  ;  ;  ;  ;  ;  ;
